O#########
O#O###X  #
O#g#O  C #
O#g#g#   #
##g#g#####
#Eg#ggggg#
#bp#g##gg#
##    #P #
O#       #
O#########