SSSSSSSSSD
S#########
S#XX X   #
S# #     #
S#C  #####
S#       #
S# CC    #
S#  E    #
S#########
SSSSSSSSSS

