SSSSSSSSSD
S#########
S#b  X  X#
S# C C   #
S#    P t#
S#   p ###
S#  C  #t#
S#    O# #
S# X   #E#
S#########
