SSSSSSSSSD
S#########
S#b  X   #
S#    P  #
S#m  C  t#
S#  ggg  #
S#  %  #t#
S#    O# #
S# CX  #E#
S#########
